-,-,-,-,-,-,-,-,-,-,-,-,-,-,-,-,-,-,-,-,-,-,-,-,-,-,-,-,-,-,-,-,-,B,-,-,-,-,-,-,B,-,-,-,-,-,-,-,-,-,-,-,-,-,-,-,-,-,-,-,-,-,-,-,-,-
-,-,-,-,C,-,-,-,-,-,-,B,-,-,-,-,-,-,-,-,-,-,-,-,-,-,-,-,-,-,-,-,B,B,-,-,-,-,-,-,B,-,-,B,B,B,B,B,-,-,-,-,-,-,-,-,-,-,-,-,-,-,-,-,-,-
-,-,-,C,C,-,B,B,-,B,-,B,-,-,-,-,-,-,-,-,-,-,-,-,-,-,-,-,-,B,B,B,B,-,-,-,B,-,-,B,B,-,-,-,-,-,-,B,-,-,-,B,-,B,-,-,-,B,-,B,-,-,-,-,-,-
-,-,-,-,C,-,B,B,-,B,-,B,-,B,-,-,-,-,-,-,-,-,-,-,-,-,-,-,-,B,B,B,B,-,B,-,-,-,-,-,B,-,-,-,-,-,B,B,-,-,-,B,B,B,-,-,-,B,-,B,-,-,-,-,-,-
B,B,B,B,B,B,B,B,B,B,B,B,B,B,B,B,B,B,B,B,B,B,B,B,B,B,B,B,B,B,B,B,B,B,B,B,B,B,B,B,B,B,B,B,B,B,B,B,B,B,B,B,B,B,B,B,B,B,B,B,B,B,B,B,B,B