-,-,-,-,-,-,-,-,-,-,-,-,-
-,-,-,-,-,-,P,-,-,-,-,-,-
-,-,-,-,-,-,-,-,-,-,-,-,-
-,-,-,-,-,-,-,-,-,-,-,-,-
B,B,B,B,B,B,B,B,B,B,B,B,B
C,C,C,C,C,C,C,C,C,C,C,C,C