A,A,A,A,A,A,A,A,A,A,A,A,A,A
A,A,A,A,A,A,A,A,A,A,A,B,A,A
A,A,A,A,A,A,B,B,A,B,A,B,A,A
A,A,P,A,A,A,B,B,A,B,A,B,A,B
B,B,B,B,B,B,B,B,B,B,B,B,B,B